20 20 20 20 20 20 20 20 20 20 20 20 20 20 20 20 20 20 20 20 20 20 20 20 20 20 20 20 20 20 20 20 20 20 20 20 20 20 20 20 20 20 20 20 20 20 20 20 20 20 
20 20 20 20 20 20 20 20 20 20 20 20 20 20 20 20 20 20 20 20 20 20 20 20 20 20 20 20 20 20 20 20 20 20 20 20 20 20 20 20 20 20 20 20 20 20 20 20 20 20 
20 20 20 20 20 20 20 20 20 20 20 20 20 20 20 20 20 20 20 20 20 20 20 20 20 20 20 20 20 20 20 20 20 20 20 20 20 20 20 20 20 20 20 20 20 20 20 20 20 20 
20 20 20 20 20 20 20 20 20 20 20 20 20 20 20 20 20 20 20 20 20 20 20 20 20 20 20 20 20 20 20 20 20 20 20 20 20 20 20 20 20 20 20 20 20 20 20 8 1 1 
20 20 20 20 20 20 20 20 20 20 20 20 20 20 20 20 20 20 20 20 20 20 20 20 20 20 20 20 20 20 20 20 20 20 20 20 20 20 20 20 20 20 20 20 20 20 8 0 0 0 
20 20 20 20 20 20 20 20 20 20 20 20 20 20 20 20 20 20 20 20 20 20 20 20 9 20 9 20 20 20 20 20 20 20 20 20 20 20 20 20 20 20 20 20 20 8 0 0 5 5 
20 20 20 20 20 20 20 20 20 9 19 9 20 20 20 20 20 20 20 20 20 20 9 47 19 9 9 9 20 20 20 9 9 9 9 9 20 20 20 9 20 20 20 20 8 0 0 4 20 20 
20 20 20 20 20 20 20 20 9 9 9 9 9 9 19 20 20 20 20 20 9 19 9 47 9 47 20 9 20 20 20 20 9 9 9 9 9 9 9 9 20 20 8 1 0 4 20 20 20 20 
20 20 20 20 20 20 20 20 9 19 9 9 19 9 9 20 20 20 20 32 33 20 20 19 9 19 9 19 47 9 9 20 9 9 20 9 20 9 8 1 1 1 0 0 4 20 20 20 20 20 
20 20 20 20 20 20 20 20 9 9 9 9 9 19 20 20 20 20 20 30 31 47 9 19 9 9 20 20 19 20 16 20 9 20 20 20 8 1 5 5 5 5 5 4 20 20 20 20 20 20 
20 20 20 20 20 20 20 20 19 19 9 19 9 9 9 19 9 9 19 14 14 14 14 14 14 14 14 14 14 14 40 20 36 35 35 35 7 4 9 19 20 19 9 20 9 20 20 20 20 20
20 20 20 20 20 20 20 20 20 9 9 19 20 20 20 20 20 19 8 1 1 2 9 19 20 19 9 9 20 20 18 14 14 14 14 8 3 14 15 14 14 14 14 14 20 20 20 20 20 20
20 20 20 20 20 20 20 20 20 9 20 20 20 20 20 20 20 20 7 0 0 3 9 19 20 20 9 20 9 9 16 19 9 8 1 0 3 9 16 47 24 25 9 20 19 20 20 20 20 20
20 20 20 20 20 20 20 20 20 19 20 20 20 20 20 20 20 20 6 5 5 0 1 2 19 47 20 20 19 20 16 19 8 0 0 0 0 2 16 19 22 23 9 19 9 20 20 20 20 20
20 20 20 20 20 20 20 20 20 9 20 20 20 20 20 20 20 20 20 9 20 6 0 29 14 14 14 14 14 14 40 8 0 0 0 0 0 29 18 14 14 14 9 9 19 20 20 20 20 20
20 20 20 20 20 20 20 20 20 16 20 20 20 20 20 20 20 24 25 20 20 20 6 4 9 20 20 20 20 20 16 7 0 0 0 0 5 4 16 19 9 9 47 9 9 20 20 20 20 20
20 20 20 20 20 20 20 20 47 16 9 20 20 20 20 20 9 22 23 9 9 9 9 20 9 20 9 20 9 20 16 7 0 0 0 3 9 20 20 19 9 9 19 9 20 20 20 20 20 20
20 20 20 20 20 20 20 9 9 46 14 9 9 9 9 19 14 14 14 14 14 14 14 14 14 15 20 20 9 20 16 6 5 5 5 0 2 20 19 9 20 19 19 20 9 20 20 20 20 20
20 20 20 20 20 20 20 20 47 9 9 20 20 20 20 20 47 19 47 38 35 35 35 35 35 16 20 9 9 9 16 19 20 20 9 0 3 19 9 20 20 20 20 20 9 20 20 20 20 20
20 20 20 20 20 20 20 20 20 20 20 20 20 20 20 20 20 20 20 39 9 9 9 9 9 16 20 20 20 19 16 9 9 19 20 6 0 1 2 20 20 20 20 20 20 20 20 20 20 20
20 20 20 20 20 20 20 20 20 20 20 20 20 20 20 20 20 20 20 39 9 9 9 9 14 40 20 20 20 9 16 9 19 20 20 9 6 5 0 2 19 9 20 20 20 20 20 20 20 20
1 1 2 19 20 20 20 20 20 20 27 32 33 27 20 20 20 20 20 39 9 9 9 9 9 16 20 20 20 9 16 9 19 47 19 20 20 20 7 3 9 19 9 20 9 47 20 20 20 20
0 0 0 1 2 20 20 20 20 27 9 30 31 19 27 20 20 20 20 39 9 9 9 9 9 16 20 24 25 19 16 19 9 9 9 19 20 19 7 3 20 9 47 19 9 9 20 20 20 20
0 0 0 0 0 2 36 35 35 35 9 19 19 9 36 35 35 35 35 37 35 35 35 35 35 16 19 22 23 9 16 9 19 19 20 20 19 9 7 3 19 19 19 20 20 19 20 20 20 20
10 10 10 10 10 10 10 10 13 14 14 14 14 14 14 14 14 14 14 14 14 14 14 14 14 17 15 14 14 14 17 14 14 14 14 14 14 14 7 3 14 14 14 14 14 14 14 14 14 14
11 11 11 11 11 11 11 12 20 9 9 19 20 9 19 9 20 20 19 9 19 9 9 20 32 33 16 19 9 20 19 9 9 9 20 20 19 9 7 3 19 9 9 9 20 9 20 20 20 20
0 0 0 5 5 5 5 4 20 19 9 20 20 20 20 9 19 20 9 20 19 9 19 9 30 31 16 9 9 19 20 9 19 20 20 20 20 19 7 3 9 20 20 9 9 9 20 20 20 20
5 5 4 20 20 19 19 20 20 20 47 20 20 20 20 20 20 20 20 20 20 20 20 19 14 14 40 9 19 20 20 20 20 20 20 20 20 20 6 0 2 20 20 20 9 20 20 20 20 20
19 20 20 19 20 20 20 20 20 20 20 20 20 20 20 20 20 20 20 20 20 20 9 19 19 9 16 19 24 25 9 9 20 20 20 20 20 20 20 7 3 19 20 20 20 20 20 20 20 20
20 20 20 20 20 20 20 20 20 20 20 20 20 20 20 20 20 20 20 20 20 20 20 9 9 9 16 9 22 23 9 19 9 9 9 19 20 20 9 7 3 9 20 20 20 20 20 20 20 20
20 20 20 20 20 20 20 20 20 20 20 20 20 20 20 20 20 20 20 20 20 20 20 19 9 19 18 14 14 14 14 14 14 9 26 9 20 20 20 7 3 47 9 20 20 20 20 20 20 20
20 20 20 20 20 20 20 20 20 20 20 20 20 20 20 9 19 20 20 20 20 20 20 20 9 9 16 9 9 47 9 19 9 9 19 9 9 20 20 7 3 9 20 20 20 20 20 20 20 20
20 20 20 20 20 20 20 20 20 20 20 20 20 20 20 20 9 9 9 9 20 20 20 20 19 9 16 9 19 9 9 20 9 9 9 20 20 20 20 7 3 9 20 20 20 20 20 20 20 20
20 20 20 20 20 20 20 20 20 20 20 20 20 8 1 1 1 2 9 20 20 20 20 20 19 9 16 9 19 9 9 20 20 20 20 20 20 20 9 7 3 9 9 9 20 20 20 20 20 20
20 20 20 20 20 20 20 20 20 19 19 9 8 0 5 5 5 0 1 2 20 20 20 9 9 19 16 20 9 20 20 20 20 20 20 20 20 19 47 7 0 2 47 9 20 20 20 20 20 20
20 20 20 20 20 20 20 20 9 8 1 1 5 4 20 9 20 6 5 0 2 19 19 19 20 19 16 9 20 20 9 20 20 9 9 9 9 19 19 7 0 0 2 9 20 20 20 20 20 20
20 20 20 20 20 20 19 9 8 0 5 4 20 20 20 47 9 20 20 7 0 2 20 20 20 9 16 9 19 19 20 20 9 9 19 19 8 1 1 0 0 0 0 19 20 20 20 20 20 20
20 20 20 20 20 19 9 8 0 4 19 20 9 9 47 19 9 9 20 6 0 3 20 19 19 9 16 9 20 20 20 20 19 9 47 8 0 0 0 0 0 0 0 2 20 20 20 20 20 20
20 20 20 20 20 19 8 0 3 20 9 19 9 9 19 9 9 19 47 20 7 3 20 20 19 9 18 14 14 14 14 14 14 14 9 7 0 0 0 0 0 0 0 0 2 9 20 20 20 20
20 20 20 20 9 19 6 0 3 47 9 9 9 19 9 9 9 9 9 20 7 0 2 9 20 20 16 20 9 20 19 20 20 20 19 6 5 0 0 0 0 0 5 5 4 20 20 20 20 20
20 20 20 20 20 20 9 7 3 20 19 9 19 20 47 9 9 19 9 9 43 44 42 14 14 14 40 20 20 20 20 20 20 20 19 9 19 6 0 0 0 4 9 19 20 9 20 20 20 20
20 20 20 20 20 20 9 6 0 1 1 1 1 2 20 20 20 9 19 20 7 0 4 19 9 19 16 47 19 20 20 20 20 20 20 20 20 9 6 0 3 9 9 9 20 20 20 20 20 20
20 20 20 20 9 20 9 9 6 5 5 5 0 0 1 1 1 1 1 1 0 4 20 20 19 9 9 20 20 20 20 20 20 20 20 20 20 19 20 7 3 9 9 20 20 20 20 20 20 20 
20 20 20 20 20 20 20 20 9 20 20 20 6 5 5 5 5 5 5 5 4 9 9 20 9 20 9 20 20 20 20 20 20 20 20 20 20 20 20 7 3 9 9 20 20 20 20 20 20 20 
20 20 20 20 20 20 20 20 20 20 20 9 20 20 20 9 9 20 20 9 9 9 20 20 20 20 20 20 20 20 20 20 20 20 20 20 20 20 19 6 0 2 9 9 20 20 20 20 20 20 
20 20 20 20 20 20 20 20 20 20 9 20 20 20 20 9 20 9 9 9 9 20 20 20 20 20 20 20 20 20 20 20 20 20 20 20 20 20 20 20 7 3 20 20 20 20 20 20 20 20 
20 20 20 20 20 20 20 20 20 20 20 20 20 20 20 20 20 20 20 20 20 20 20 20 20 20 20 20 20 20 20 20 20 20 20 20 20 20 20 8 0 4 20 20 20 20 20 20 20 20 
20 20 20 20 20 20 20 20 20 20 20 20 20 20 20 20 20 20 20 9 20 20 20 20 20 20 20 20 20 20 20 20 20 20 20 20 20 20 20 7 4 20 20 20 20 20 20 20 20 20 
20 20 20 20 20 20 20 20 20 20 20 20 20 20 20 20 20 20 20 20 20 20 20 20 20 20 20 20 20 20 20 20 20 20 20 20 20 20 8 3 20 20 20 20 20 20 20 20 20 20 
20 20 20 20 20 20 20 20 20 20 20 20 20 20 20 20 20 20 20 20 20 20 20 20 20 20 20 20 20 20 20 20 20 20 20 20 20 20 7 3 20 20 20 20 20 20 20 20 20 20 
