157 157 157 157 157 157 157 111 157 157 157 157 157 157 157 157 157 157 157 111 111 157 157 157 157 157 157 157 157 111 157 157 157 157 157 157 157 157 157 157 157 157 157 157 157 157 157 157 157 157
157 157 157 157 157 157 157 110 157 157 157 157 157 157 157 157 157 157 157 110 110 157 157 157 157 157 157 157 157 110 157 157 157 157 157 157 157 157 157 157 157 157 157 157 157 157 157 157 157 157
157 157 157 157 157 157 157 157 157 157 157 157 157 157 157 157 157 157 157 157 157 157 157 157 157 157 157 157 157 157 157 157 157 157 157 157 157 157 157 111 157 157 157 157 157 157 157 157 157 157
157 157 157 157 157 157 157 157 157 157 157 157 157 111 157 157 157 157 157 157 157 157 157 157 157 157 111 157 157 157 157 111 157 157 157 157 157 157 157 110 157 157 157 157 157 157 157 157 157 157
157 157 111 157 157 157 157 157 157 157 157 157 157 110 157 157 157 157 157 157 157 157 157 157 157 157 110 157 157 157 157 110 157 157 157 157 157 157 157 157 157 157 157 157 157 157 157 157 157 157
157 157 110 157 157 157 157 157 157 157 157 157 157 58 50 50 50 50 50 50 50 50 50 50 50 50 50 50 50 50 50 50 50 50 50 50 50 50 50 157 157 157 157 157 157 157 157 157 157 157
157 157 157 157 157 157 157 157 157 157 157 157 59 74 127 127 127 69 69 69 69 69 69 69 69 69 127 127 127 69 69 69 69 69 69 69 69 49 69 166 157 157 157 157 111 157 157 157 157 157
157 157 157 157 157 157 157 157 157 157 157 157 52 75 127 127 49 127 69 69 69 69 69 69 69 49 127 251 252 69 69 69 49 69 69 69 53 157 157 166 157 157 157 157 110 157 157 157 157 157
157 157 157 157 157 157 111 157 157 157 157 157 52 157 157 157 112 157 123 125 157 157 157 157 157 157 157 154 160 157 157 157 157 157 157 167 53 157 157 166 157 157 157 157 157 157 157 157 157 157
157 157 157 157 157 157 110 157 157 157 157 157 52 78 79 157 112 157 126 128 157 157 157 157 157 157 157 154 160 157 157 157 157 157 157 167 53 157 157 166 157 157 157 157 157 157 157 157 157 157
157 157 157 157 157 157 157 157 157 157 157 111 52 100 101 157 112 157 126 128 157 157 157 157 157 157 157 155 0 159 157 157 157 157 157 167 53 157 157 166 157 157 157 157 157 157 157 157 157 157
111 157 157 157 157 157 157 157 157 157 157 110 52 102 103 121 117 157 126 128 157 157 157 157 157 157 157 157 154 160 157 157 157 157 157 167 51 50 50 166 157 157 157 157 111 157 157 157 157 157
110 157 157 157 157 157 157 157 157 157 157 157 52 157 157 157 112 157 126 128 157 157 157 157 157 157 157 157 154 160 157 157 157 157 157 157 71 69 69 166 157 157 157 157 110 157 157 157 157 157
157 157 157 157 157 157 157 157 157 157 157 157 52 157 157 157 115 113 126 128 157 157 157 157 157 157 157 157 154 160 157 157 157 157 157 157 157 157 157 166 157 157 157 157 157 157 157 157 157 157
157 157 157 157 157 157 157 157 157 157 157 157 52 123 124 124 124 124 127 128 157 157 157 157 157 157 157 157 154 160 157 157 157 157 157 104 105 56 55 111 157 157 157 157 157 157 157 157 157 157
157 157 157 157 157 111 157 157 157 157 157 157 52 129 130 130 130 130 130 131 157 157 157 157 157 157 157 157 154 160 157 157 157 157 157 106 107 53 157 110 157 157 157 157 111 157 157 157 157 157
157 157 157 157 157 110 157 157 157 157 157 157 52 157 157 157 157 157 157 112 157 157 157 157 157 157 157 157 154 160 157 157 157 157 157 108 109 51 50 50 50 50 50 157 110 157 157 157 157 157
157 157 157 157 157 157 157 157 157 157 157 157 52 157 157 157 157 157 157 112 157 157 157 157 157 157 157 157 154 160 157 157 157 157 157 157 119 70 69 69 69 69 69 51 50 50 50 50 50 50
157 157 157 157 157 157 157 157 157 157 157 157 52 157 157 157 104 105 157 112 157 157 157 157 157 157 157 157 154 160 157 157 157 157 157 157 112 70 49 69 69 69 69 70 69 69 69 69 69 69
157 157 157 157 157 157 157 157 157 157 111 157 52 157 157 157 106 107 157 112 157 157 156 157 157 157 157 157 154 160 157 157 157 157 165 113 164 157 157 157 153 152 159 70 69 69 69 69 69 69
157 157 157 157 157 157 157 157 157 157 110 157 52 157 157 157 108 109 113 117 157 157 119 157 157 157 157 153 0 158 157 157 157 157 112 162 157 157 157 157 154 0 0 152 152 152 152 152 152 152
157 157 157 157 157 157 157 157 157 157 157 157 52 157 157 157 157 157 157 112 157 157 112 157 157 157 157 154 160 157 157 157 157 157 112 157 157 157 157 157 154 0 0 0 0 0 0 0 0 0
157 111 157 157 157 157 157 157 157 157 157 157 52 157 157 157 157 157 162 112 78 79 112 157 157 157 157 154 160 157 157 157 157 157 112 157 157 157 157 157 154 0 0 0 0 0 0 0 0 0
157 110 157 157 157 157 157 157 157 157 157 157 52 157 157 157 157 157 157 112 100 101 112 157 157 157 153 0 158 157 157 157 163 157 112 157 157 157 153 152 0 0 0 0 0 0 0 0 0 0
157 157 157 157 157 157 157 157 157 157 157 157 52 157 157 157 156 121 113 161 113 113 122 113 113 116 44 44 121 113 113 113 113 113 122 113 113 116 10 10 10 10 10 10 10 10 10 10 10 10
157 157 157 157 157 157 157 157 157 157 157 157 52 157 157 157 157 157 157 112 157 132 133 134 163 157 154 160 157 157 157 157 157 157 157 157 157 162 48 11 11 11 11 11 11 11 11 11 11 11
157 157 157 157 157 157 157 111 157 157 157 157 157 55 55 55 55 144 157 112 157 135 136 137 157 153 0 158 56 55 55 55 55 55 55 55 55 55 55 55 55 55 55 55 55 55 55 55 55 55
157 157 157 157 157 157 157 110 157 157 157 157 157 157 157 157 162 52 157 112 157 138 139 140 157 154 160 157 51 50 50 50 50 50 50 50 50 50 157 157 111 157 157 157 157 157 157 157 157 157
157 157 157 157 157 157 157 157 157 157 157 157 157 157 157 157 111 52 157 112 157 141 141 142 157 154 160 111 70 69 49 69 69 69 69 69 69 69 53 157 110 157 157 157 111 157 157 157 157 157
157 157 157 157 157 157 157 157 157 157 157 157 157 157 157 157 110 52 157 112 157 157 157 119 157 154 160 110 53 157 157 157 157 162 157 157 157 157 166 157 157 157 157 157 110 157 157 157 157 157
157 157 157 111 157 157 157 157 157 157 157 157 157 50 50 50 50 57 157 112 157 157 162 112 157 155 0 159 51 157 157 157 157 157 157 157 162 157 166 157 157 157 157 157 157 157 157 157 157 157
157 157 157 110 157 157 157 157 157 157 111 157 52 69 69 69 69 72 157 115 113 113 113 117 157 157 154 160 70 151 157 157 157 157 157 157 157 157 166 157 157 157 157 157 157 157 157 157 157 157
157 157 157 157 157 157 157 157 157 157 110 157 52 69 69 69 69 73 163 123 124 124 125 112 157 157 154 0 159 151 157 157 157 163 157 157 157 157 166 111 157 157 157 157 157 157 157 157 111 157
157 157 157 157 157 157 157 157 157 157 157 157 52 157 132 133 134 157 157 126 127 127 128 112 157 157 155 0 160 151 157 157 157 157 157 157 157 157 166 110 157 157 157 157 157 157 157 157 110 157
111 157 157 157 157 157 111 157 157 157 157 157 52 157 135 136 137 163 157 126 127 127 128 112 157 157 157 154 160 151 163 157 157 157 162 157 163 157 166 157 157 157 157 157 157 157 157 157 157 157
110 157 157 157 157 157 110 157 157 157 157 157 52 157 138 139 140 157 157 126 127 127 128 112 157 157 157 154 160 51 50 50 50 50 50 50 50 50 166 157 157 157 157 157 157 111 157 157 157 157
157 157 157 157 157 157 157 157 157 157 157 157 52 157 141 119 142 157 157 129 130 130 131 112 157 157 162 154 160 70 69 69 69 69 69 69 49 69 166 157 157 157 157 157 157 110 157 157 157 157
157 157 157 157 157 157 157 157 157 157 157 157 52 162 157 115 113 113 113 113 113 113 113 117 157 157 157 154 160 157 157 157 157 157 157 157 157 157 166 157 157 157 157 157 157 157 157 157 157 157
157 157 157 111 157 157 157 157 111 157 157 157 52 157 157 157 157 157 157 157 157 157 157 112 157 157 153 0 158 157 162 163 157 157 157 157 157 157 166 157 157 157 157 157 157 157 157 157 157 157
157 157 157 110 157 157 157 157 110 157 157 157 52 157 157 104 105 157 157 157 163 157 157 112 157 157 154 160 157 157 157 157 157 157 157 157 157 163 166 157 111 157 157 157 157 157 157 157 157 157
157 157 157 157 157 157 157 157 157 157 157 157 52 157 157 106 107 157 157 157 157 157 163 112 157 157 155 0 159 157 157 157 157 157 157 157 157 157 166 157 110 157 157 157 157 157 157 157 111 157
157 111 157 157 157 157 157 157 157 157 157 157 52 162 157 108 109 157 157 157 157 157 157 112 157 157 163 154 160 157 157 157 157 163 157 157 157 157 166 157 157 157 157 157 157 157 157 157 110 157
157 110 157 157 157 157 157 111 157 157 157 157 52 157 157 157 121 113 113 113 113 113 113 122 113 113 116 44 44 157 157 157 157 157 157 56 55 55 157 157 157 157 157 157 157 157 157 157 157 157
157 157 157 157 157 157 157 110 157 157 157 157 52 157 157 157 157 157 157 157 157 157 157 157 157 157 157 154 160 157 157 157 157 157 157 166 157 157 157 157 157 157 111 157 157 157 157 157 157 157
157 157 157 157 157 157 157 157 157 157 157 157 157 55 55 55 55 55 55 55 55 55 55 55 55 55 55 55 55 55 55 55 55 55 55 157 157 157 157 157 157 157 110 157 157 157 157 157 157 157
157 157 157 157 157 157 157 157 157 157 157 157 157 157 157 157 157 157 157 157 157 157 157 157 157 157 157 157 157 157 157 157 157 157 157 157 157 157 157 157 157 157 157 157 157 157 157 157 157 157
157 157 157 111 157 157 157 157 157 157 157 157 157 157 157 157 111 157 157 157 157 157 157 157 157 157 157 157 157 157 111 157 157 157 157 157 157 157 157 157 157 157 157 157 157 157 157 157 111 157 
157 157 157 110 157 157 157 157 157 157 157 157 157 157 157 157 110 157 157 157 157 157 157 111 157 157 157 157 157 157 110 157 157 157 157 157 111 157 157 157 157 157 157 157 157 157 157 157 110 157 
157 157 157 157 157 157 157 157 111 157 157 157 157 157 157 157 157 157 157 157 157 157 157 110 157 157 157 157 157 157 157 157 157 157 157 157 110 157 157 157 157 157 157 157 157 111 157 157 157 157 
157 157 157 157 157 157 157 157 110 157 157 157 157 157 157 157 157 157 157 157 157 157 157 157 157 157 157 157 157 157 157 157 157 157 157 157 157 157 157 157 157 157 157 157 157 110 157 157 157 157 
