226 226 226 226 226 226 226 226 226 226 226 226 226 226 226 226 226 226 226 226 226 226 226 226 226 226 226 226 226 226 226 226 226 226 226 226 226 226 226 226 226 226 226 226 226 226 226 226 226 226 
226 226 226 226 226 226 226 226 226 226 226 226 226 226 226 226 226 226 226 226 226 226 226 226 226 226 226 226 226 226 226 226 226 226 226 226 226 226 226 226 226 226 226 226 226 226 226 226 226 226 
226 226 226 226 226 226 226 226 226 226 226 226 226 226 226 226 226 226 226 226 226 226 226 226 226 226 226 226 226 226 226 226 226 226 226 226 226 226 226 226 226 226 226 226 226 226 226 226 226 226 
226 226 226 226 226 226 226 226 226 226 226 226 226 226 226 226 226 226 226 226 226 226 226 226 226 226 226 226 226 226 226 226 226 226 226 226 226 226 226 226 226 226 226 226 226 226 226 226 226 226 
226 226 226 226 226 226 226 226 226 226 226 226 226 226 226 226 226 226 226 226 226 226 226 226 226 226 226 226 226 226 226 226 226 226 226 226 226 226 226 226 226 226 226 226 226 226 226 226 226 226 
226 226 226 226 226 226 226 226 226 226 226 226 226 226 226 226 226 226 226 226 226 226 226 226 226 226 226 226 226 226 226 226 226 226 226 226 226 226 226 226 226 226 226 226 226 226 226 226 226 226 
226 226 226 226 226 226 226 226 226 226 226 226 226 226 226 226 226 226 226 226 226 226 226 226 226 226 226 226 226 226 226 226 226 226 226 226 226 226 226 226 226 226 226 226 226 226 226 226 226 226 
226 226 226 226 226 226 226 226 226 226 226 226 226 226 226 226 226 226 226 226 226 226 226 204 255 207 226 226 226 226 226 226 226 226 226 226 226 226 226 226 226 226 226 226 226 226 226 226 226 226 
226 226 226 226 226 226 226 226 226 226 200 202 202 202 202 203 200 202 202 202 202 202 202 217 221 218 202 202 202 202 202 202 202 203 200 202 202 202 202 203 226 226 226 226 226 226 226 226 226 226 
226 226 226 226 226 226 226 226 226 226 204 234 234 234 234 218 217 234 234 234 234 234 234 234 221 234 234 234 234 234 234 234 234 218 217 234 234 234 234 207 226 226 226 226 226 226 226 226 226 226 
226 226 226 226 226 226 226 226 226 226 204 220 219 219 219 234 234 220 219 219 219 219 219 219 222 245 219 219 219 219 219 219 219 234 234 220 219 219 219 207 226 226 226 226 226 226 226 226 226 226 
226 226 226 226 226 226 226 226 226 226 204 221 212 212 212 245 219 222 212 212 208 211 209 212 212 210 212 212 212 212 212 212 208 245 219 222 211 212 212 207 226 226 226 226 226 226 226 226 226 226 
226 226 226 226 226 226 226 226 226 226 204 221 210 212 212 212 212 212 209 210 212 212 212 212 209 211 208 212 212 212 212 212 209 210 212 212 212 208 212 207 226 226 226 226 226 226 226 226 226 226 
226 226 226 226 226 226 226 226 226 226 204 221 211 209 212 212 212 208 212 211 212 212 212 212 212 212 210 212 208 212 212 212 212 211 208 212 212 212 212 207 226 226 226 226 226 226 226 226 226 226 
226 226 226 226 226 226 226 226 226 226 204 221 212 208 210 212 212 212 212 212 212 212 212 212 212 212 211 212 212 212 212 212 212 212 212 212 212 212 212 207 226 226 226 226 226 226 226 226 226 226 
226 226 226 226 226 226 226 226 226 226 213 229 250 212 211 230 215 215 215 215 215 215 229 250 212 212 212 230 215 215 215 215 215 215 229 212 209 210 230 231 226 226 226 226 226 226 226 226 226 226 
226 226 226 226 226 226 226 226 226 226 226 204 221 212 212 207 200 202 202 202 202 203 204 221 212 212 212 207 200 201 201 201 201 203 204 250 208 211 207 226 226 226 226 226 226 226 226 226 226 226 
226 226 226 226 226 226 226 226 226 226 200 217 221 210 209 218 217 234 234 234 234 207 204 221 212 212 212 207 204 234 234 234 234 218 217 221 210 209 218 203 226 226 226 226 226 226 226 226 226 226 
226 226 226 226 226 226 226 226 226 226 204 234 221 211 208 234 234 220 219 223 219 207 204 221 210 209 212 207 204 220 223 219 219 234 234 228 211 212 234 207 226 226 226 226 226 226 226 226 226 226 
226 226 226 226 226 226 226 226 226 226 204 220 222 209 212 245 219 222 212 212 208 207 204 228 211 208 212 207 204 221 212 212 212 219 223 222 212 212 245 207 226 226 226 226 226 226 226 226 226 226 
226 226 226 226 226 226 226 226 226 226 204 221 212 212 212 212 212 210 208 212 212 207 204 221 212 212 212 207 204 221 208 209 212 212 212 212 212 210 212 207 226 226 226 226 226 226 226 226 226 226 
226 226 226 226 226 226 226 226 226 226 204 221 212 210 208 212 212 211 209 212 212 207 204 228 212 210 212 207 204 221 210 211 212 212 212 212 209 208 212 207 226 226 226 226 226 226 226 226 226 226 
226 226 226 226 226 226 226 226 226 226 204 221 208 211 209 212 212 212 212 212 212 207 204 228 208 211 212 207 204 221 212 212 212 212 212 210 211 212 212 207 226 226 226 226 226 226 226 226 226 226 
226 226 226 226 226 226 226 226 226 226 213 215 215 215 215 215 215 215 215 215 215 231 213 229 209 212 230 231 213 214 214 214 214 214 214 214 214 214 214 231 226 226 226 226 226 226 226 226 226 226 
226 226 226 226 226 226 226 226 226 226 226 226 226 226 226 226 200 201 201 201 201 203 200 217 212 212 218 203 200 201 201 201 201 203 226 226 226 226 226 226 226 226 226 226 226 226 226 226 226 226 
226 226 226 226 226 226 226 226 226 226 226 226 226 226 226 200 217 234 234 247 234 218 217 247 212 212 235 218 217 234 234 234 235 218 203 226 226 226 226 226 226 226 226 226 226 226 226 226 226 226 
226 226 226 226 226 226 226 226 226 226 226 226 226 226 226 204 224 220 223 219 223 225 224 221 212 212 212 234 234 220 223 223 219 235 207 226 226 226 226 226 226 226 226 226 226 226 226 226 226 226 
226 226 226 226 226 226 226 226 226 226 226 226 226 226 226 204 220 222 212 212 212 245 219 222 208 212 212 245 223 222 212 212 212 245 207 226 226 226 226 226 226 226 226 226 226 226 226 226 226 226 
226 226 226 226 226 226 226 226 226 226 226 226 226 226 226 204 221 211 212 212 212 209 212 212 212 211 210 212 212 212 212 210 212 212 207 226 226 226 226 226 226 226 226 226 226 226 226 226 226 226 
226 226 226 226 226 226 226 226 226 226 226 226 226 226 226 204 228 212 254 254 212 210 212 212 254 254 212 212 210 212 254 254 209 212 207 226 226 226 226 226 226 226 226 226 226 226 226 226 226 226 
226 226 226 226 226 226 226 226 226 226 226 226 226 226 226 204 228 212 254 254 212 211 212 212 254 254 212 212 211 209 254 254 212 212 207 226 226 226 226 226 226 226 226 226 226 226 226 226 226 226 
226 226 226 226 226 226 226 226 226 226 226 226 226 226 226 204 221 212 212 209 212 212 212 212 212 210 212 212 212 210 211 212 209 212 207 226 226 226 226 226 226 226 226 226 226 226 226 226 226 226 
226 226 226 226 226 226 226 226 226 226 226 226 226 226 226 204 228 212 211 210 212 212 212 212 209 211 212 212 212 212 212 212 210 212 207 226 226 226 226 226 226 226 226 226 226 226 226 226 226 226 
226 226 226 226 226 226 226 226 226 226 226 226 226 226 226 213 229 250 212 212 212 230 229 250 212 212 212 230 229 250 212 212 211 230 231 226 226 226 226 226 226 226 226 226 226 226 226 226 226 226 
226 226 226 226 226 226 226 226 226 226 226 226 226 226 226 226 213 215 215 215 215 231 213 229 212 212 230 231 213 215 215 215 215 231 226 226 226 226 226 226 226 226 226 226 226 226 226 226 226 226 
226 226 226 226 226 226 226 226 226 226 226 226 226 226 226 226 226 226 226 226 200 201 201 217 212 212 218 201 201 203 226 226 226 226 226 226 226 226 226 226 226 226 226 226 226 226 226 226 226 226 
226 226 226 226 226 226 226 226 226 226 226 226 226 226 226 226 226 226 226 226 204 255 247 234 212 212 234 235 255 207 226 226 226 226 226 226 226 226 226 226 226 226 226 226 226 226 226 226 226 226 
226 226 226 226 226 226 226 226 226 226 226 226 226 226 226 226 226 226 226 226 204 254 212 216 212 212 216 212 254 207 226 226 226 226 226 226 226 226 226 226 226 226 226 226 226 226 226 226 226 226 
226 226 226 226 226 226 226 226 226 226 226 226 226 226 226 226 226 226 226 226 204 212 254 226 212 212 226 212 254 207 226 226 226 226 226 226 226 226 226 226 226 226 226 226 226 226 226 226 226 226 
226 226 226 226 226 226 226 226 226 226 226 226 226 226 226 226 226 226 226 226 204 212 254 226 212 212 226 254 212 207 226 226 226 226 226 226 226 226 226 226 226 226 226 226 226 226 226 226 226 226 
226 226 226 226 226 226 226 226 226 226 226 226 226 226 226 226 226 226 226 226 204 256 256 226 212 212 226 256 256 207 226 226 226 226 226 226 226 226 226 226 226 226 226 226 226 226 226 226 226 226 
226 226 226 226 226 226 226 226 226 226 226 226 226 226 226 226 226 226 226 226 204 212 212 212 212 212 212 212 212 207 226 226 226 226 226 226 226 226 226 226 226 226 226 226 226 226 226 226 226 226 
226 226 226 226 226 226 226 226 226 226 226 226 226 226 226 226 226 226 226 226 213 214 215 215 215 214 215 214 215 231 226 226 226 226 226 226 226 226 226 226 226 226 226 226 226 226 226 226 226 226 
226 226 226 226 226 226 226 226 226 226 226 226 226 226 226 226 226 226 226 226 226 226 226 226 226 226 226 226 226 226 226 226 226 226 226 226 226 226 226 226 226 226 226 226 226 226 226 226 226 226 
226 226 226 226 226 226 226 226 226 226 226 226 226 226 226 226 226 226 226 226 226 226 226 226 226 226 226 226 226 226 226 226 226 226 226 226 226 226 226 226 226 226 226 226 226 226 226 226 226 226 
226 226 226 226 226 226 226 226 226 226 226 226 226 226 226 226 226 226 226 226 226 226 226 226 226 226 226 226 226 226 226 226 226 226 226 226 226 226 226 226 226 226 226 226 226 226 226 226 226 226 
226 226 226 226 226 226 226 226 226 226 226 226 226 226 226 226 226 226 226 226 226 226 226 226 226 226 226 226 226 226 226 226 226 226 226 226 226 226 226 226 226 226 226 226 226 226 226 226 226 226 
226 226 226 226 226 226 226 226 226 226 226 226 226 226 226 226 226 226 226 226 226 226 226 226 226 226 226 226 226 226 226 226 226 226 226 226 226 226 226 226 226 226 226 226 226 226 226 226 226 226 
226 226 226 226 226 226 226 226 226 226 226 226 226 226 226 226 226 226 226 226 226 226 226 226 226 226 226 226 226 226 226 226 226 226 226 226 226 226 226 226 226 226 226 226 226 226 226 226 226 226 
226 226 226 226 226 226 226 226 226 226 226 226 226 226 226 226 226 226 226 226 226 226 226 226 226 226 226 226 226 226 226 226 226 226 226 226 226 226 226 226 226 226 226 226 226 226 226 226 226 226 
