157 157 157 157 157 157 157 157 157 157 157 157 157 157 157 157 157 157 157 157 157 157 157 157 157 157 157 157 157 157 157 157 157 157 157 157 157 157 157 157 157 157 157 157 157 157 157 157 157 157 
157 157 157 157 157 157 157 157 157 157 157 157 157 157 157 157 157 157 157 271 157 157 157 157 157 157 157 157 157 157 157 157 157 157 157 157 157 157 157 157 157 157 157 157 157 157 157 157 157 157 
157 157 157 157 157 157 157 157 157 157 157 157 157 157 157 157 157 157 157 157 157 157 157 157 157 157 157 157 157 157 157 157 157 157 157 157 157 157 157 157 157 157 157 157 157 157 157 157 157 157 
157 157 271 157 157 157 157 157 157 157 157 157 157 157 157 271 157 157 157 157 157 157 157 157 157 157 157 157 157 157 157 157 157 157 157 157 157 157 157 157 157 157 157 157 157 157 271 157 157 157 
157 157 157 157 157 157 157 157 157 157 157 157 157 157 157 157 157 157 157 157 157 157 157 157 157 157 157 157 157 157 157 271 157 157 157 157 157 157 157 157 157 157 157 157 157 157 157 157 157 157 
157 157 157 157 157 157 157 157 157 157 157 157 157 157 157 157 157 157 157 157 157 157 157 157 157 157 157 157 157 157 157 271 157 157 157 157 157 157 157 157 157 157 157 157 157 157 157 157 157 157 
157 157 157 157 157 157 157 157 157 157 157 157 157 157 157 157 157 157 157 157 157 157 157 157 157 157 157 157 157 157 157 157 157 157 157 157 157 157 157 157 157 157 157 157 157 157 157 157 157 157 
157 157 157 157 157 157 157 157 157 157 271 157 157 157 157 157 157 157 157 157 157 157 157 157 157 157 271 157 157 157 157 157 157 157 157 157 157 157 157 157 157 157 157 157 157 157 157 157 157 157 
157 157 157 157 157 157 157 157 157 157 157 157 157 157 157 157 157 157 157 157 157 157 157 157 157 157 157 157 157 157 157 157 157 157 157 157 157 157 157 157 157 157 271 157 157 157 157 157 157 157 
157 157 157 157 157 157 157 157 157 157 157 157 157 157 157 157 157 157 157 157 157 157 157 157 157 157 157 157 157 157 157 157 157 157 157 157 157 157 157 157 157 157 157 157 157 157 157 157 157 157 
157 157 157 157 157 157 271 157 157 157 157 157 157 157 157 157 157 157 157 157 157 157 157 157 157 157 157 157 157 157 157 157 157 271 157 157 157 157 157 157 157 157 157 157 157 157 157 157 271 157 
157 157 157 157 157 157 157 157 157 157 157 157 157 157 157 157 271 157 157 157 271 157 157 157 157 157 157 157 157 157 157 157 157 157 157 157 157 157 157 157 157 157 157 157 157 157 157 157 157 157 
157 157 157 157 157 157 157 157 157 157 157 157 157 157 157 157 157 157 157 157 157 157 157 157 157 157 157 157 157 157 157 157 157 157 157 157 157 157 157 157 157 157 157 157 157 157 157 157 157 157 
157 157 157 157 157 157 157 157 157 157 157 157 157 157 157 157 157 157 157 157 157 157 157 157 157 157 157 157 157 157 157 271 157 157 157 157 157 157 157 157 157 157 157 157 157 157 157 157 157 157 
157 157 157 157 157 157 157 157 157 157 157 157 157 157 157 157 157 157 157 157 157 157 157 157 157 271 157 157 157 157 157 157 157 157 157 271 157 157 157 271 157 157 157 157 157 157 157 157 157 157 
157 157 157 157 157 157 157 157 157 157 157 157 271 157 157 157 157 157 157 157 157 271 157 157 157 271 157 157 157 157 157 157 157 157 157 157 157 157 157 157 157 157 157 157 157 157 157 157 157 157 
157 157 157 157 271 157 157 157 157 157 157 157 157 157 157 157 157 50 50 50 50 50 50 50 50 50 50 50 50 50 50 50 50 50 50 50 157 157 157 157 157 157 157 157 157 157 157 157 157 157 
157 157 157 157 157 157 157 157 157 157 157 157 157 157 271 157 52 69 69 69 69 69 69 69 69 69 69 69 69 69 69 69 69 69 69 69 339 157 157 157 271 157 157 157 157 157 157 157 157 157
157 157 157 157 157 157 157 157 157 157 157 157 157 157 157 157 52 69 69 266 267 69 69 127 127 69 69 69 69 69 69 69 69 69 69 69 339 157 157 157 157 157 157 157 157 157 157 157 157 157
157 157 157 157 157 157 157 157 157 157 271 271 157 157 50 50 57 157 157 126 128 157 157 157 162 157 271 157 111 157 157 157 157 271 157 111 339 157 157 157 157 157 157 157 157 157 157 157 157 157
157 157 157 157 157 157 157 157 157 157 157 157 157 52 127 127 72 157 162 126 128 271 157 157 157 157 157 157 110 123 124 124 124 124 125 110 339 157 157 157 157 157 157 157 271 157 157 157 157 157
157 157 157 157 157 157 157 157 157 157 157 157 157 52 69 49 73 271 157 126 128 157 157 157 271 157 157 157 119 126 127 127 127 127 128 157 339 157 157 157 157 157 157 157 157 157 157 157 157 157
157 157 157 157 157 157 157 157 157 157 157 157 157 52 212 211 212 157 157 126 128 120 113 113 113 113 113 113 117 126 127 127 127 127 128 157 339 157 157 157 157 157 157 157 157 157 157 157 157 157
157 157 157 157 157 157 157 157 271 157 157 157 157 52 212 119 210 157 157 126 128 112 269 269 270 269 269 270 112 126 127 127 127 127 128 157 339 157 157 157 157 157 157 157 157 157 157 157 157 157
157 157 157 157 157 157 157 157 157 157 157 157 157 52 210 112 271 157 162 126 128 112 162 270 257 258 269 157 112 129 130 130 130 130 131 111 339 157 157 271 157 157 157 157 157 157 157 157 157 157
157 157 157 157 157 157 157 157 157 157 157 157 271 52 157 112 157 157 157 126 128 112 269 269 259 260 269 270 112 157 271 162 157 157 157 110 339 157 157 157 157 157 271 157 157 157 157 157 157 157
157 157 157 157 157 157 157 157 157 157 157 157 157 52 157 112 157 157 157 126 128 112 157 157 157 119 157 157 112 157 157 157 157 157 157 157 339 157 157 157 157 157 157 157 157 157 157 157 157 157
157 157 157 157 157 157 157 271 157 157 157 157 157 52 157 115 113 113 113 268 268 122 113 113 113 161 113 113 122 113 113 116 156 157 157 157 339 157 157 157 157 157 157 157 157 157 157 157 157 157
157 157 157 157 157 157 157 157 157 157 157 157 157 52 157 157 157 271 163 126 128 157 157 157 157 112 157 271 157 157 157 157 157 157 157 157 339 157 157 157 157 157 157 157 157 157 157 157 157 157
157 157 157 157 157 157 157 157 157 157 157 157 157 52 157 157 157 157 157 126 128 157 157 157 157 112 157 157 157 157 157 157 157 157 157 163 339 157 157 271 157 157 157 271 157 157 157 157 157 157
157 157 157 157 157 157 157 157 157 157 157 157 157 52 157 163 157 157 157 126 128 157 163 157 271 112 157 157 163 157 157 157 157 157 157 157 339 157 157 157 157 157 157 157 157 157 157 157 157 157
157 157 157 157 157 157 157 157 157 271 157 157 157 52 157 157 157 157 157 126 128 157 271 157 157 112 157 157 157 157 157 157 157 163 157 157 339 157 157 157 157 271 157 157 157 157 157 157 157 157
157 157 157 157 157 157 157 157 157 157 157 157 157 157 55 55 55 55 55 55 55 55 55 144 262 263 56 55 55 55 55 55 55 55 55 55 157 157 157 157 157 157 157 157 157 157 157 157 157 157 
157 157 157 157 157 157 157 157 157 157 157 157 157 157 157 157 157 157 157 157 157 157 157 52 264 265 53 157 157 157 157 157 157 157 157 157 157 157 157 157 157 157 157 157 157 157 157 157 157 157 
157 157 157 271 157 157 157 157 157 157 157 157 157 157 271 157 157 157 157 157 157 157 157 52 271 119 53 157 157 157 157 157 157 157 157 157 157 157 157 157 157 157 157 157 157 157 157 157 157 157 
157 157 157 157 157 157 157 157 157 157 157 157 157 157 157 157 157 157 157 157 157 157 157 52 157 112 53 157 157 271 157 157 157 157 157 157 157 157 157 157 157 271 157 157 157 157 157 157 271 157 
157 157 157 157 157 157 157 157 157 157 157 157 157 157 157 157 157 157 157 157 157 157 157 52 157 112 53 157 157 157 157 157 157 157 157 157 157 157 157 157 157 157 157 157 157 157 157 157 157 157 
157 157 157 157 157 157 157 157 157 157 157 157 157 157 157 157 157 157 157 157 157 271 157 52 271 112 53 157 157 157 157 157 157 157 157 157 157 157 157 157 157 157 157 157 157 157 157 157 157 157 
157 157 157 157 157 157 157 157 157 157 157 157 157 157 157 157 157 157 157 157 157 157 157 52 157 112 53 157 157 157 157 157 157 271 157 157 157 157 157 157 157 157 157 157 157 157 157 157 157 157 
157 157 157 271 157 157 157 157 157 157 157 157 157 157 157 157 157 157 157 157 157 157 157 52 157 112 53 157 157 157 157 157 157 157 157 157 157 157 157 157 157 157 157 157 157 157 157 157 157 157 
157 157 157 157 157 157 157 157 157 157 157 157 157 157 157 157 157 157 157 157 157 157 157 52 157 112 53 157 157 157 157 271 157 157 157 157 157 157 157 271 157 157 157 157 157 157 157 157 157 157 
157 157 157 157 157 157 157 157 271 157 157 157 157 157 271 157 157 157 157 157 157 157 271 52 157 112 53 157 157 157 157 157 157 157 157 157 157 157 157 157 157 157 157 157 157 157 157 157 157 157 
157 157 157 157 157 157 157 157 157 157 157 157 157 157 157 157 157 271 157 157 157 157 157 52 157 112 53 157 157 157 157 157 157 157 157 157 157 157 157 157 157 157 157 157 157 157 157 157 271 157 
157 157 157 157 157 157 157 157 157 157 157 157 157 157 157 157 157 157 157 157 157 157 157 52 157 112 53 157 157 271 157 157 157 157 157 157 157 157 157 157 157 157 157 157 157 157 157 157 157 157 
157 157 157 157 157 157 157 157 157 157 157 157 157 157 157 157 157 157 157 157 157 157 157 52 157 112 53 157 157 157 157 157 157 157 157 157 157 157 157 157 157 157 157 157 157 157 157 157 157 157 
157 157 157 157 157 157 157 157 157 157 157 157 157 157 157 157 157 157 157 157 157 157 157 52 157 112 53 157 157 157 157 157 271 157 157 157 157 157 157 157 157 271 157 157 157 157 157 157 157 157 
157 157 157 157 157 157 157 271 157 157 157 157 157 157 157 157 157 157 157 157 157 271 157 52 111 112 53 157 157 157 157 157 157 157 157 157 157 157 157 157 157 157 157 157 157 157 157 157 157 157 
157 157 157 271 157 157 157 157 157 157 157 157 157 157 157 157 157 157 157 157 157 157 157 52 110 112 53 157 157 157 157 157 157 157 157 157 157 157 157 157 157 157 157 157 157 157 157 157 157 157 
157 157 157 157 157 157 157 157 157 157 157 157 157 157 157 157 157 157 157 157 157 271 157 52 157 112 53 157 157 157 271 157 157 157 157 271 157 157 157 157 157 157 157 157 157 157 157 157 157 157 
157 157 157 157 157 157 157 157 157 157 157 157 157 157 271 157 157 157 157 157 157 157 157 52 157 112 53 157 157 157 157 157 157 157 157 157 157 157 157 157 157 157 157 157 157 157 157 157 157 157 
