330 330 330 330 330 330 330 330 330 330 330 330 330 330 330 330 330 330 330 330 330 330 330 330 330 330 330 330 330 330 330 330 330 330 330 330 330 330 330 330 330 330 330 330 330 330 330 330 330 330 
330 330 330 330 330 330 330 330 330 330 330 330 330 330 330 330 330 330 330 330 330 330 330 330 330 330 330 330 330 330 330 330 330 330 330 330 330 330 330 330 330 330 330 330 330 330 330 330 330 330 
330 330 330 330 330 330 330 330 330 330 330 330 330 330 330 330 330 330 330 330 330 330 330 330 330 330 330 330 330 330 330 330 330 330 330 330 330 330 330 330 330 330 330 330 330 330 330 330 330 330 
330 330 330 330 330 330 330 330 330 330 330 330 330 330 330 330 330 330 330 330 330 330 330 330 330 330 330 330 330 330 330 330 330 330 330 330 330 330 330 330 330 330 330 330 330 330 330 330 330 330 
330 330 330 330 330 330 330 330 330 330 330 330 330 330 330 330 330 330 330 330 330 330 330 330 330 330 330 330 330 330 330 330 330 330 330 330 330 330 330 330 330 330 330 330 330 330 330 330 330 330 
330 330 330 330 330 330 330 330 330 330 330 330 330 330 330 330 330 330 330 330 330 330 330 330 330 330 330 330 330 330 330 330 330 330 330 330 330 330 330 330 330 330 330 330 330 330 330 330 330 330 
330 330 330 330 330 330 330 330 330 330 330 330 330 330 330 330 330 330 330 330 330 330 330 330 330 330 330 330 330 330 330 330 330 330 330 330 330 330 330 330 330 330 330 330 330 330 330 330 330 330 
330 330 330 330 330 330 330 330 330 330 330 330 330 330 330 330 330 330 330 330 330 330 330 330 330 330 330 330 330 330 330 330 330 330 330 330 330 330 330 330 330 330 330 330 330 330 330 330 330 330 
330 330 330 330 330 330 330 330 330 330 330 330 330 330 330 330 330 330 330 330 330 330 330 330 330 330 330 330 330 330 330 330 330 330 330 330 330 330 330 330 330 330 330 330 330 330 330 330 330 330 
330 330 330 330 330 330 330 330 330 330 330 330 330 330 330 330 330 330 330 330 330 330 330 330 330 330 330 330 330 330 330 330 330 330 330 330 330 330 330 330 330 330 330 330 330 330 330 330 330 330 
330 330 330 330 330 330 330 330 330 330 330 330 330 330 330 330 330 330 330 330 330 330 330 330 330 330 330 330 330 330 330 330 330 330 330 330 330 330 330 330 330 330 330 330 330 330 330 330 330 330 
330 330 330 330 330 330 330 330 330 330 330 330 330 330 330 330 330 330 330 330 330 330 330 360 350 350 350 390 330 330 330 330 330 330 330 330 330 330 330 330 330 330 330 330 330 330 330 330 330 330
330 330 330 330 330 330 330 330 330 330 330 330 330 330 330 330 330 330 330 330 330 330 330 360 335 335 335 390 330 330 330 330 330 330 330 330 330 330 330 330 330 330 330 330 330 330 330 330 330 330
330 330 330 330 330 330 330 330 330 330 330 330 330 330 330 330 330 330 330 330 330 330 330 360 335 335 335 390 330 330 330 330 330 330 330 330 330 330 330 330 330 330 330 330 330 330 330 330 330 330
330 330 330 330 330 330 330 330 330 330 330 330 330 330 330 330 330 330 330 330 330 330 330 360 335 335 397 390 330 330 330 330 330 330 330 330 330 330 330 330 330 330 330 330 330 330 330 330 330 330
330 330 330 330 330 330 330 330 330 330 330 330 330 330 330 330 330 330 330 330 330 330 330 370 399 335 398 385 330 330 330 330 330 330 330 330 330 330 330 330 330 330 330 330 330 330 330 330 330 330
330 330 330 330 330 330 330 330 330 330 330 330 330 330 330 330 360 350 350 350 390 330 330 330 360 335 390 330 330 330 330 330 330 330 330 330 330 330 330 330 330 330 330 330 330 330 330 330 330 330
330 330 330 330 330 330 330 330 360 350 350 350 350 350 350 350 350 397 335 335 350 350 350 350 350 335 350 350 350 350 350 350 350 350 350 390 330 330 330 330 330 330 330 330 330 330 330 330 330 330
330 330 330 330 330 330 330 330 360 335 335 335 335 335 335 335 335 335 335 335 335 335 335 335 335 335 335 335 335 335 335 335 335 335 335 350 390 330 330 330 330 330 330 330 330 330 330 330 330 330
330 330 330 330 330 330 330 330 360 335 398 375 375 375 375 375 399 335 335 335 398 375 375 375 375 375 375 375 399 335 398 375 399 335 335 335 350 390 330 330 330 330 330 330 330 330 330 330 330 330
330 330 330 330 330 330 330 330 360 335 390 330 330 330 330 330 370 399 335 398 385 330 330 330 330 330 330 330 360 335 390 330 370 399 335 335 335 350 390 330 330 330 330 330 330 330 330 330 330 330
330 330 330 330 330 330 330 330 360 335 390 330 330 330 330 330 330 360 335 390 330 330 330 330 330 330 330 330 360 335 390 330 330 370 399 335 335 335 350 390 330 330 330 330 330 330 330 330 330 330
330 330 330 330 330 330 330 360 350 335 350 350 390 330 330 330 330 360 335 390 330 330 360 350 350 350 390 360 350 335 350 390 330 330 370 399 335 335 335 350 390 330 330 330 330 330 330 330 330 330
330 330 330 330 330 330 330 360 335 335 335 335 390 330 330 330 330 360 335 390 330 330 360 335 335 397 350 350 335 335 335 390 330 330 330 370 399 335 335 335 390 330 330 330 330 330 330 330 330 330
330 330 330 330 330 330 330 360 335 335 335 335 390 330 330 330 330 360 335 390 330 330 360 335 335 335 335 335 335 335 335 390 330 330 330 330 360 335 335 335 390 330 330 330 330 330 330 330 330 330
330 330 330 330 330 330 330 360 335 335 335 335 390 330 330 330 330 360 335 390 330 330 360 335 335 335 398 399 335 335 335 390 330 330 330 330 360 335 335 335 390 330 330 330 330 330 330 330 330 330
330 330 330 330 330 330 330 370 375 375 375 375 385 330 330 330 330 360 335 390 330 330 370 375 375 375 385 370 375 375 375 385 330 330 330 330 360 335 335 335 390 330 330 330 330 330 330 330 330 330
330 330 330 330 330 330 330 330 330 330 330 330 330 330 330 330 330 360 335 390 330 330 330 330 330 330 330 330 330 330 330 330 330 330 330 330 360 335 335 335 390 330 330 330 330 330 330 330 330 330
330 330 330 330 330 330 330 330 330 330 330 330 330 330 330 330 330 360 335 390 330 330 360 350 350 350 350 350 350 350 350 350 350 350 350 350 350 335 335 335 350 390 330 330 330 330 330 330 330 330
330 330 330 330 330 330 330 330 330 330 330 330 330 330 330 330 330 360 335 390 330 330 360 335 335 335 335 335 335 335 335 335 335 335 335 335 335 335 335 335 335 390 330 330 330 330 330 330 330 330
330 330 330 330 330 330 330 330 330 330 330 330 330 330 330 330 330 360 335 390 330 330 360 335 335 335 335 335 335 335 335 335 335 335 335 335 335 335 335 335 335 390 330 330 330 330 330 330 330 330
330 330 330 330 330 330 330 330 330 330 330 330 330 330 330 330 360 350 335 350 390 360 350 335 335 335 335 398 375 375 375 375 375 375 375 399 335 398 375 375 375 385 330 330 330 330 330 330 330 330
330 330 330 330 330 330 330 330 330 330 330 330 330 330 330 330 360 335 335 397 390 360 335 335 335 335 335 390 330 330 330 330 330 330 330 360 335 390 330 330 330 330 330 330 330 330 330 330 330 330
330 330 330 330 330 330 330 330 330 330 330 330 330 330 330 330 360 335 335 335 390 360 335 335 335 335 335 390 360 350 350 350 390 330 330 360 335 390 330 330 330 330 330 330 330 330 330 330 330 330
330 330 330 330 330 330 330 330 330 330 330 330 330 330 330 330 360 335 335 335 350 350 335 335 335 335 335 350 350 397 335 335 390 330 330 360 335 390 330 330 330 330 330 330 330 330 330 330 330 330
330 330 330 330 330 330 330 330 330 330 330 330 330 330 330 330 360 335 335 335 335 335 335 335 335 335 335 335 335 335 335 335 390 330 330 360 335 390 360 350 350 350 390 330 330 330 330 330 330 330
330 330 330 330 330 330 330 330 330 330 330 330 330 330 330 330 360 335 335 335 398 399 335 335 335 335 335 398 399 335 335 335 390 330 330 360 335 350 350 335 335 335 390 330 330 330 330 330 330 330
330 330 330 330 330 330 330 330 330 330 330 330 330 330 330 330 370 375 375 375 385 370 375 399 335 398 375 385 370 375 375 375 385 330 330 360 335 335 335 335 335 335 390 330 330 330 330 330 330 330
330 330 330 330 330 330 330 330 330 330 330 330 330 330 330 330 330 330 330 330 330 360 350 350 335 350 350 390 330 330 330 330 330 330 330 370 375 375 399 335 335 335 390 330 330 330 330 330 330 330
330 330 330 330 330 330 330 330 330 330 330 330 330 330 330 330 330 330 330 330 330 360 335 335 335 335 335 390 330 330 330 330 330 330 330 330 330 330 370 375 375 375 385 330 330 330 330 330 330 330
330 330 330 330 330 330 330 330 330 330 330 330 330 330 330 330 330 330 330 330 330 360 335 398 375 399 335 390 330 330 330 330 330 330 330 330 330 330 330 330 330 330 330 330 330 330 330 330 330 330
330 330 330 330 330 330 330 330 330 330 330 330 330 330 330 330 330 330 330 330 330 360 335 390 330 360 335 390 330 330 330 330 330 330 330 330 330 330 330 330 330 330 330 330 330 330 330 330 330 330
330 330 330 330 330 330 330 330 330 330 330 330 330 330 330 330 330 330 330 330 330 360 335 350 350 350 335 390 330 330 330 330 330 330 330 330 330 330 330 330 330 330 330 330 330 330 330 330 330 330
330 330 330 330 330 330 330 330 330 330 330 330 330 330 330 330 330 330 330 330 330 360 335 335 335 335 397 390 330 330 330 330 330 330 330 330 330 330 330 330 330 330 330 330 330 330 330 330 330 330
330 330 330 330 330 330 330 330 330 330 330 330 330 330 330 330 330 330 330 330 330 370 375 375 375 375 375 385 330 330 330 330 330 330 330 330 330 330 330 330 330 330 330 330 330 330 330 330 330 330
330 330 330 330 330 330 330 330 330 330 330 330 330 330 330 330 330 330 330 330 330 330 330 330 330 330 330 330 330 330 330 330 330 330 330 330 330 330 330 330 330 330 330 330 330 330 330 330 330 330
330 330 330 330 330 330 330 330 330 330 330 330 330 330 330 330 330 330 330 330 330 330 330 330 330 330 330 330 330 330 330 330 330 330 330 330 330 330 330 330 330 330 330 330 330 330 330 330 330 330
330 330 330 330 330 330 330 330 330 330 330 330 330 330 330 330 330 330 330 330 330 330 330 330 330 330 330 330 330 330 330 330 330 330 330 330 330 330 330 330 330 330 330 330 330 330 330 330 330 330
330 330 330 330 330 330 330 330 330 330 330 330 330 330 330 330 330 330 330 330 330 330 330 330 330 330 330 330 330 330 330 330 330 330 330 330 330 330 330 330 330 330 330 330 330 330 330 330 330 330 
330 330 330 330 330 330 330 330 330 330 330 330 330 330 330 330 330 330 330 330 330 330 330 330 330 330 330 330 330 330 330 330 330 330 330 330 330 330 330 330 330 330 330 330 330 330 330 330 330 330 
