12 12 12 12 12 12 12 12 12 12 12 12 12 12 12 12 12 12 12 12 12 12 13 14 45 12 12 12 12 12 12 12 12 12 12 12 12 12 12 12 12 12 12 12 12 12 12 12 12 12
12 12 12 12 12 12 12 12 12 12 12 12 12 12 12 12 12 12 12 12 12 12 13 14 45 12 12 12 12 12 12 12 12 12 12 12 12 12 12 12 12 12 12 12 12 12 12 12 12 12
12 12 12 12 12 12 12 12 12 12 12 12 12 12 12 12 12 12 12 12 12 12 13 14 45 12 12 12 12 12 12 12 12 12 12 12 12 12 12 12 12 12 12 12 12 12 12 12 12 12
12 12 12 12 12 12 12 12 12 12 12 12 12 12 12 12 12 12 12 12 12 12 13 14 45 12 12 12 12 12 12 12 12 12 12 12 12 12 12 12 12 12 12 12 12 12 12 12 12 12
12 12 12 12 12 12 12 12 12 12 12 12 12 12 12 12 12 12 12 12 12 12 13 14 45 12 12 12 12 12 12 12 12 12 12 12 12 12 12 12 12 12 12 12 12 12 12 12 12 12
12 12 12 12 12 12 12 12 12 12 12 12 12 12 12 12 12 12 12 12 12 12 13 14 45 12 12 12 12 12 12 12 12 12 12 12 12 12 12 12 12 12 12 12 12 12 12 12 12 12
12 12 12 12 12 12 12 12 12 12 12 12 12 12 12 12 12 12 12 12 12 12 13 14 45 12 12 12 12 12 12 12 12 12 12 12 12 12 12 12 12 12 12 12 12 12 12 12 12 12
12 12 12 12 12 12 12 12 12 12 12 12 12 12 12 12 12 12 12 12 12 12 13 14 45 12 12 12 12 12 12 12 12 12 12 12 12 12 12 12 12 12 12 12 12 12 12 12 12 12
12 12 12 12 12 12 12 12 12 12 12 12 12 12 12 12 12 12 12 12 12 12 13 14 45 12 12 12 12 12 12 12 12 12 12 12 12 12 12 12 12 12 12 12 12 12 12 12 12 12
12 12 12 12 12 12 12 12 12 12 12 12 12 12 12 12 12 12 12 12 12 12 13 14 45 12 12 12 12 12 12 12 12 12 12 12 12 12 12 12 12 12 12 12 12 12 12 12 12 12
12 12 12 12 12 12 12 12 12 12 12 12 12 12 12 12 12 12 12 12 12 12 13 14 45 12 12 12 12 12 12 12 12 12 12 12 12 12 12 12 12 12 12 12 12 12 12 12 12 12
12 12 12 12 12 12 12 12 12 12 12 12 12 12 12 12 12 12 12 12 12 12 13 14 45 12 12 12 12 12 12 12 12 12 12 12 12 12 12 12 12 12 12 12 12 12 12 12 12 12
12 12 12 12 12 12 12 12 12 12 12 12 12 12 12 12 12 12 12 12 12 12 13 14 45 12 12 12 12 12 12 12 12 12 12 12 12 12 12 12 12 12 12 12 12 12 12 12 12 12
12 12 12 12 12 12 12 12 12 12 12 12 12 12 12 12 12 12 12 12 12 12 13 14 45 12 12 12 12 12 12 12 12 12 12 12 12 12 12 12 12 12 12 12 12 12 12 12 12 12
12 12 12 12 12 12 12 12 12 12 12 12 12 12 12 12 12 12 12 12 12 12 13 14 45 12 12 12 12 12 12 12 12 12 12 12 12 12 12 12 12 12 12 12 12 12 12 12 12 12
12 12 12 12 12 12 12 12 12 12 12 12 12 12 12 12 12 12 12 12 12 12 13 14 45 12 12 12 12 12 12 12 12 12 12 12 12 12 12 12 12 12 12 12 12 12 12 12 12 12
12 12 12 12 12 12 12 12 12 12 12 12 12 12 12 12 12 12 12 12 12 12 13 14 45 12 12 12 12 12 12 12 12 12 12 12 12 12 12 12 12 12 12 12 12 12 12 12 12 12
13 32 16 31 16 17 31 33 12 12 12 12 12 12 12 12 12 12 12 12 12 12 13 14 45 12 12 12 12 12 12 12 12 12 12 12 12 12 12 12 12 12 12 12 12 12 12 12 12 12
13 35 18 18 18 18 18 34 12 12 12 12 12 12 12 12 12 12 12 12 12 12 13 14 46 47 47 47 47 47 52 12 12 12 12 12 12 12 12 12 12 12 12 12 12 12 12 12 12 12
13 35 18 18 18 67 18 34 12 12 12 12 12 12 12 12 12 12 12 12 12 12 19 14 11 10 10 10 10 11 45 12 12 12 12 12 12 12 12 12 12 12 12 12 12 12 12 12 12 12
13 35 18 18 18 18 18 34 12 12 12 12 12 12 12 12 12 12 12 12 12 13 11 14 10 10 10 10 11 10 45 12 12 12 12 12 12 12 12 12 12 12 12 12 12 12 12 12 12 12
13 35 67 18 18 18 18 34 12 12 12 12 12 12 12 12 12 12 12 12 12 13 10 22 15 15 15 15 15 27 45 12 12 12 12 12 12 12 12 12 12 12 12 12 12 12 12 12 12 12
13 16 16 17 30 31 17 16 12 12 12 12 12 12 12 12 12 12 12 12 12 13 10 14 11 10 10 11 10 10 45 12 12 12 12 12 12 12 12 12 12 12 12 12 12 12 12 12 12 12
13 48 20 10 14 10 10 60 61 47 47 47 47 47 47 47 47 47 47 47 47 19 11 14 10 49 48 48 48 48 50 12 12 12 12 12 12 12 12 12 12 12 12 12 12 12 12 12 12 12
12 12 13 10 14 11 10 10 10 11 11 10 10 10 11 10 10 11 10 10 10 10 10 14 10 45 12 12 12 12 12 12 12 12 12 12 12 12 12 12 12 12 12 12 12 12 12 12 12 12
12 12 13 11 26 15 15 15 15 24 15 15 15 15 15 15 15 15 15 15 15 15 15 23 62 45 12 12 12 12 12 12 12 12 12 12 12 12 12 12 12 12 12 12 12 12 12 12 12 12
12 12 13 11 10 10 10 10 11 14 10 10 10 11 10 10 10 10 10 10 11 10 10 14 10 45 12 12 12 12 12 12 12 12 12 12 12 12 12 12 12 12 12 12 12 12 12 12 12 12
12 12 58 54 54 54 54 57 10 28 56 54 54 54 54 54 54 48 48 48 48 20 11 14 11 45 12 12 12 12 12 12 12 12 47 47 47 52 12 12 12 12 12 12 12 12 12 12 12 12
12 13 59 53 53 53 53 53 11 10 10 53 53 53 53 53 53 55 12 12 12 13 10 14 10 45 12 12 12 12 12 12 12 13 10 10 11 45 12 12 12 12 12 12 12 12 12 12 12 12
12 13 11 42 41 41 41 41 41 64 41 41 41 41 41 40 11 45 12 12 12 13 10 14 10 45 12 12 12 12 12 12 12 13 10 10 10 45 12 12 12 12 12 12 12 12 12 12 12 12
12 13 10 43 44 44 44 44 44 65 44 44 44 44 44 39 10 45 12 12 12 13 11 14 10 45 12 12 12 12 12 12 12 12 20 68 49 50 12 12 12 12 12 12 12 12 12 12 12 12
12 13 11 43 44 44 44 44 44 65 44 44 44 44 44 39 11 45 12 12 12 13 10 14 10 45 12 12 12 12 12 12 12 12 13 69 45 12 12 12 12 12 12 12 12 12 12 12 12 12
12 13 11 43 44 44 37 37 37 66 37 37 37 44 44 39 11 45 12 12 12 13 10 14 11 45 12 12 12 12 12 12 12 12 13 69 45 12 12 12 12 12 12 12 12 12 12 12 12 12
12 13 11 43 44 38 10 11 10 10 11 10 51 36 44 39 10 45 12 12 12 12 20 14 49 50 12 12 12 12 12 12 12 12 19 70 46 47 47 52 12 12 12 12 12 12 12 12 12 12
12 13 10 43 39 11 51 10 10 10 10 10 10 11 43 39 10 45 12 12 12 12 13 14 45 12 12 12 12 12 12 12 12 19 11 10 11 10 10 46 52 12 12 12 12 12 12 12 12 12
12 13 10 43 39 10 10 10 10 11 10 10 10 10 43 39 11 45 12 12 12 12 13 14 45 12 12 12 12 12 12 12 13 10 10 10 10 10 10 10 45 12 12 12 12 12 12 12 12 12
12 13 10 43 39 10 10 10 10 10 10 10 11 10 43 39 10 45 12 12 12 12 13 14 46 47 47 47 47 47 47 47 19 11 10 10 10 11 10 10 45 12 12 12 12 12 12 12 12 12
12 13 11 43 39 10 10 11 10 10 10 10 51 10 43 39 10 45 12 12 12 12 13 22 15 15 15 15 15 15 15 15 27 10 10 10 63 10 10 11 45 12 12 12 12 12 12 12 12 12
12 13 11 43 44 40 10 10 10 11 10 10 10 42 44 39 11 45 12 12 12 12 13 14 62 11 49 48 48 48 48 20 11 10 11 10 10 10 10 10 45 12 12 12 12 12 12 12 12 12
12 13 10 43 44 44 41 41 41 41 41 41 41 44 44 39 10 45 12 12 12 12 13 14 10 49 50 12 12 12 12 12 20 10 10 11 10 10 10 11 45 12 12 12 12 12 12 12 12 12
12 13 10 43 44 44 44 44 44 44 44 44 44 44 44 39 10 45 12 12 12 12 13 14 49 50 12 12 12 12 12 12 12 48 48 48 48 48 48 48 50 12 12 12 12 12 12 12 12 12
12 13 11 36 37 37 37 37 37 37 37 37 37 37 37 38 11 45 12 12 12 12 13 14 45 12 12 12 12 12 12 12 12 12 12 12 12 12 12 12 12 12 12 12 12 12 12 12 12 12
12 13 11 10 10 11 11 10 11 10 10 10 11 11 10 10 11 45 12 12 12 12 13 14 45 12 12 12 12 12 12 12 12 12 12 12 12 12 12 12 12 12 12 12 12 12 12 12 12 12
12 12 48 48 48 48 48 48 48 48 48 48 48 48 48 48 48 50 12 12 12 32 16 29 16 33 12 12 12 12 12 12 12 12 12 12 12 12 12 12 12 12 12 12 12 12 12 12 12 12
12 12 12 12 12 12 12 12 12 12 12 12 12 12 12 12 12 12 12 12 12 35 18 18 18 34 12 12 12 12 12 12 12 12 12 12 12 12 12 12 12 12 12 12 12 12 12 12 12 12
12 12 12 12 12 12 12 12 12 12 12 12 12 12 12 12 12 12 12 12 12 35 18 18 18 34 12 12 12 12 12 12 12 12 12 12 12 12 12 12 12 12 12 12 12 12 12 12 12 12
12 12 12 12 12 12 12 12 12 12 12 12 12 12 12 12 12 12 12 12 12 35 18 18 18 34 12 12 12 12 12 12 12 12 12 12 12 12 12 12 12 12 12 12 12 12 12 12 12 12
12 12 12 12 12 12 12 12 12 12 12 12 12 12 12 12 12 12 12 12 12 35 18 18 18 34 12 12 12 12 12 12 12 12 12 12 12 12 12 12 12 12 12 12 12 12 12 12 12 12
12 12 12 12 12 12 12 12 12 12 12 12 12 12 12 12 12 12 12 12 12 16 31 16 17 16 12 12 12 12 12 12 12 12 12 12 12 12 12 12 12 12 12 12 12 12 12 12 12 12
12 12 12 12 12 12 12 12 12 12 12 12 12 12 12 12 12 12 12 12 12 12 12 12 12 12 12 12 12 12 12 12 12 12 12 12 12 12 12 12 12 12 12 12 12 12 12 12 12 12
